7 12
############
###   #   ##
#   #   #  #
### ### ####
##  ##  ##H#
### #C#    #
############